⎾-----------------⏋
|                  |
|        ||        |
|        ||        |
|        ||        |
|        ||        |
|        ||        |
|        ||        |
|        ||        |
|--------||--------|
|        ||        |
|        ||        |
|        ||        |
|        ||        |
|        ||        |
|        ||        |
|        ||        |
|        ||        |
|                  |
-------------------
